
F 35,190,73





SO                  textures/SO.xpm


EA textures/EA.xpm

       NO         textures/NO.xpm

C 255,255,255

                WE textures/WE.xpm




111111111111
1         11
1          1
111111111111
100S01     1
11111111111111
11         1
111111111111111






