
F 35,190,73
SO                  textures/SO.xpm
EA textures/EA.xpm

       NO         textures/NO.xpm

C 15,6,40

                WE textures/WE.xpm
111111111111111
111111000111111
111110000000111
111100000001111
111000001000111
1100000S0100011
100001111100001
110000111000011
111000010000111
111100000001111
111110000011111
111111000111111
111111111111111
