NO sprites/north.xpm
SO sprites/south.xpm
WE sprites/west.xpm
EA sprites/east.xpm

F 20,20,20
C 200,200,200

11111
10001
1001
10001
10001111
10001S0      1
110011111111
10001
10001
10001
10001
10001
11111


