NO sprites/north.xpm
SO sprites/south.xpm
WE sprites/west.xpm
EA sprites/east.xpm

F 20,20,20
C 200,200,200

        11111
        10001
        10001
        10001
        10001
    N   10001
        11001
        10001
        10001
        10001
        10001
        10001
        11111
